#$#################################################
#.#.............#.#.#.#.....#.#.#.....#.#...#.....#
#.#.###.#.#.#.#.#.#.#.#.#####.#.#####.#.###.#.###.#
#..^#...#.#.#.#.......#.#.....#...#.~.#.#.#...#...#
##.########.#######.###.#.#.###.#.#.###.#.#.#.#####
#.......#...#.....#.#...#.#.....#......^....#.#...#
#######.#.###.#.#.#.#.#######.#############.#.###.#
#...#.......#.#.#.#.#...#.#.#.#.#.#...#.....#.....#
#.#######.###.#####.#.#.#.#.###.#.#.###.###########
#.......#..~#...#.....#.#.#...#...#.........#.#.#.#
#.#.###.###.#.#.#.#.#.###.###.#.#####.#######.#.#.#
#.#.#.......#.#...#.#.#.#.....#.....#.......#.#...#
#.#####.#.#.###.#.#####.#.#.#####.#.#.###.#.#.###.#
#...#...#.#.....#.^.......#.......#.#...#.#.......#
#.#.#####.#####.#.#.###.#########.#####.#.#.#######
#.#.#...#.#.....#.#...#.........#...#.#.#.#...#...#
###.###.#.#####.#.#########.#####.###.#####.###.###
#.#.#.......#.#.#...#...~...#.#...#...#.#^........#
#.#.###.#.#.#.###.###########.#.#.#.#.#.#.#######.#
#.....#.#.#...#.....#...#...#.#.#...#.#.#.#.#...#.#
#####.#.###.###.#.#.#.###.###.###.#####.#.#.###.#.#
#...#.#.#.....#.#.#.#.#.......#...#.....#...#...#.#
#.#.#.#####.#.#.###.#.###.#.###.#.###.#.#.#####.#.#
#.#.#.#.....#.#...#.....#.#.#...#...#.#...#...#...#
###.#####.#########.###.#.#.#####.###.#.#####.#.###
#.#........~....#...#.#.^.#.#.#...#.#.#...#.#.....#
#.###.#.###.#.#######.###.###.###.#.#######.#.###.#
#.#.#.#...#.#.#...#.....#.......#.....#.......#...#
#.#.#.#.###.#.#.#.#####.###.###.#.#.#.#########.###
#.#...#...#.#...#.#.#.........#.#.#.#...#.#.#.....#
#.#.#.###.###.###.#.#####.#########.#####.#.#####.#
#.#.#...#...#.#...#.....#.#...#.......#....^..#.#.#
#.###.#####.#.###.#.#.#.#.###.###.#.###.#######.#.#
#.#.#...#.....#...#.#.#.#.#.....#.#...#...#...#...&
#.#.#.#.#.#.###.###.###########.#.#.#.###.#.#.#.#.#
#.....#.#^#.#...#.#...#.#.....#.#.#.#.#.#...#.#.#.#
#####.#.#.#####.#.###.#.###.###.#.###.#.#.###.#.###
#.....#.#...#...#.....#.........#...#.....#.....#.#
#.###.#####.#######.#####.###.#####.###.###.#.#.#.#
#.#.#.#.#...#.........#.#.#...^.......#...#.#.#...#
###.#.#.###.#.#######.#.#.#.#####.#.#####.#.#.#.#.#
#...#.#...#.....#.......#.#.#.....#.#...#.#.#.#.#.#
###.#.#.#########.###.###.#######.###.###########.#
#.#.#.#.#.....#...#.......#.#.#.....#...#.#.......#
#.#~#.#.#.#####.#.#####.###.#.#.#####.#.#.#####.###
#.#.....^...#.#.#.#.......#...#.....#.#..~#.#.#...#
#.#.#.#####.#.#.#.#.###.###.#.###.#.#.#.#.#.#.#.###
#.#.#.#.....#.#.#.#...#...#.#.....#...#.#.#.......#
#.#.#####.###.###.#.#######.###.#####.###.#.###.###
#.....#...#.......#.....#...#.......#......^......#
###################################################
