#$#######################################
#...........#.........#...#.#...........#
#.###.#.###.#.#####.###.#.#.###########.#
#...#.#...#.....#.#.....#.....#.#...#.#.#
#.#####.#.#.#####.#.#.#####.###.#.###.#.#
#.#.....#.#.#.#.....#.#.#.#.#.#.#.......#
###.#####.###.#.#.#####.#.#.#.#.#####.###
#...#.....#.#.#.#...#.#...........#.#...#
#.#.###.###.#.#.###.#.#.#.#####.###.###.#
#.#.#.........#...#...#.#.#...#.........#
###.###.###########.###.###.#.###.#######
#...#.......#.#...#...#.#.#.#...#.#.....#
#.#####.#.###.###.#######.###.###.#.#.###
#...#...#.#.#...#.......#.#.........#...#
#.#######.#.#.###.#.###.#.###.###.#.###.#
#.#.....#.....#...#...#.#.....#.#.#.#...#
###.#.###.#.###.#####.###.#####.#.#######
#.#.#...#.#.#...#...#...#.#...#.......#.#
#.#####.#.###.#.###.#.#.###.#####.#.###.#
#...........#.#.#...#.#...#.....#.#.#...#
#####.#######.###.###.#.#.#.###.#.#####.#
#.....#.........#.#.#.#.#.#...#.#...#...#
#####.#########.#.#.#.#.###.#####.#.#.#.#
#...#...#...#.....#...#.....#...#.#.#.#.#
#.#####.###.#.#.#####.###.###.#####.###.#
#.#...#.#...#.#.#.......#.#.#...#...#...#
#.#.#.#.#.###.#.#####.#.###.#.#.#.###.#.#
#.#.#...#.#...#...#...#.#.....#.#...#.#.#
#.#####.#.#####.###.#########.#####.###.#
#...#...#.......#.......#.......#.......#
###.#.#.#.#.#######.#######.###.###.#.###
#.....#...#.#...#...#.......#...#.#.#...#
###.#.#.#.###.#################.#.#######
#...#.#.#...........#.........#.#...#...#
#.#####.#.#.###.#####.#.#######.###.###.#
#.#.....#.#.#.#.#.....#.#.#...#.....#...#
#.#####.#####.#.#####.###.#.#.#.#.#.###.#
#.....#.#...^.#...#.........#.#.#.#...#.#
#.#.#.#.###.###.#.#.#.#.#.###.#.#.###.#.#
#.#.#.#...#.....#.~.#.#.#...#...#...#...#
#######################################&#
