#$###################
#.......#...........#
#.###.#.#.###.#.###.#
#.....#...#...#.#...#
#.#.#########.#.#.###
#.#.#.#...#.........#
#.#.#.#.#######.#.#.#
#.#.#...........#.#.#
#.#.#.#.###.###.#.#.#
#.....#.#&....#.#...#
###.###.#.#.###.#.#.#
#.^.....#.#.#.......#
#.###.###.#...#.#####
#.......#.#.#.#.....#
#.#####.#.#.#####.#.#
#.#.....#..^......#.#
#.#.#.#####.#.###.#.#
#...#...#...#.#.....#
#.###.###.###.#.###.#
#.........#.......#.#
#####################
