MMMMMMMMMM
MSMMMMMMMM
MPMPPPPMMM
MPMPMMMMMM
MPMPPPPPPM
MPMPMMMMPM
MPPPMPPPPM
MPMMMMMPMM
MPPMPPPPPM
MMMMMMMOMM