#$#################################################
#.#.............#.#.#.#.....#.#.#.....#.#...#.....#
#.#.###.#.#.#.#.#.#.#.#.#####.#.#####.#.###.#.###.#
#...#...#.#.#.#.......#.#.....#...#...#.#.#...#...#
##.########.#######.###.#.#.###.#.#.###.#.#.#.#####
#.......#...#.....#.#...#.#.....#...........#.#...#
#######.#.###.#.#.#.#.#######.#############.#.###.#
#...#.......#.#.#.#.#...#.#.#.#.#.#...#.....#.....#
#.#######.###.#####.#.#.#.#.###.#.#.###.###########
#.......#...#...#.....#.#.#...#...#.........#.#.#.#
#.#.###.###.#.#.#.#.#.###.###.#.#####.#######.#.#.#
#.#.#.......#.#...#.#.#.#.....#.....#.......#.#...#
#.#####.#.#.###.#.#####.#.#.#####.#.#.###.#.#.###.#
#...#...#.#.....#.........#.......#.#...#.#.......#
#.#.#####.#####.#.#.###.#########.#####.#.#.#######
#.#.#...#.#.....#.#...#.........#...#.#.#.#...#...#
###.###.#.#####.#.#########.#####.###.#####.###.###
#.#.#.......#.#.#...#.......#.#...#...#.#.........#
#.#.###.#.#.#.###.###########.#.#.#.#.#.#.#######.#
#.....#.#.#...#.....#...#...#.#.#...#.#.#.#.#...#.#
#####.#.###.###.#.#.#.###.###.###.#####.#.#.###.#.#
#...#.#.#.....#.#.#.#.#.......#...#.....#...#...#.#
#.#.#.#####.#.#.###.#.###.#.###.#.###.#.#.#####.#.#
#.#.#.#.....#.#...#.....#.#.#...#...#.#...#...#...#
###.#####.#########.###.#.#.#####.###.#.#####.#.###
#.#.............#...#.#...#.#.#...#.#.#...#.#.....#
#.###.#.###.#.#######.###.###.###.#.#######.#.###.#
#.#.#.#...#.#.#...#.....#.......#.....#.......#...#
#.#.#.#.###.###.#.#####.###.###.#.#.#.#########.###
#.#...#...#.#...#.#.#.........#.#.#.#...#.#.#.....#
#.#.#.###.###.###.#.#####.#########.#####.#.#####.#
#.#.#...#...#.#...#.....#.#...#.......#.......#.#.#
#.###.#####.#.###.#.#.#.#.###.###.#.###.#######.#.#
#.#.#...#.....#...#.#.#.#.#.....#.#...#...#...#...&
#.#.#.#.#.#.###.###.###########.#.#.#.###.#.#.#.#.#
#.....#.#.#.#...#.#...#.#.....#.#.#.#.#.#...#.#.#.#
#####.#.#.#####.#.###.#.###.###.#.###.#.#.###.#.###
#.....#.#...#...#.....#.........#...#.....#.....#.#
#.###.#####.#######.#########.#####.###.###.#.#.#.#
#.#.#.#.#...#.........#.#.#...........#...#.#.#...#
###.#.#.###.#.#######.#.#.#.#####.#.#####.#.#.#.#.#
#...#.#...#.....#.......#.#.#.....#.#...#.#.#.#.#.#
###.#.#.#########.###.###.#######.###.###########.#
#.#.#.#.#.....#...#.......#.#.#.....#...#.#.......#
#.#.#.#.#.#####.#.#####.###.#.#.#####.#.#.#####.###
#.#.........#.#.#.#.......#...#.....#.#...#.#.#...#
#.#.#.#####.#.#.#.#.###.###.#.###.#.#.#.#.#.#.#.###
#.#.#.#.....#.#.#.#...#...#.#.....#...#.#.#.......#
#.#.#####.###.###.#.#######.###.#####.###.#.###.###
#.....#...#.......#.....#...#.......##............#
###################################################
