..#############################
..........#.#...#...#...#.....#
###.#.#.#.#.#.#####.#.#.###.#.#
#...#.#.#.....#.....#.#...#.#.#
###.#.#.#####.#.#######.###.#.#
#...#.#.....#.#...#.#.#.....#.#
###.#########.###.#.#.#.#####.#
#.........#.#.......#.....#...#
#.###.#.#.#.#########.#######.#
#.#.#.#.#...#...#...#...#.....#
#.#.#.#.#.###.#####.#.#####.###
#...#.#.#.#...#.........#.....#
#####.#.###.#.#.###.#####.#.###
#.....#.....#...#.....#...#.#.#
###.#.#.###.###.###.###.###.#.#
#...#.#.#...#.....#.#...#.#.#.#
#.#######.###.#########.#.###.#
#.#.#...#.#...#.#.#.#.#.#.....#
#.#.#.#.###.#.#.#.#.#.###.###.#
#...#.#.#...#.......#.#...#...#
#.#####.#.#.#####.###.###.#.###
#.......#.#.#...#.#.......#...#
###.#####.#.#.#.#.###.#.#####.#
#...#.....#...#.#...#.#...#.#.#
#.#.#.###.###.###.###.###.#.###
#.#.#...#.#.....#.#...#.......#
#####.#####.#####.#.#.#######.#
#...#...#.#...#.....#...#.....#
#.#.#.#.#.#.#######.#####.###.#
#.#...#.#.....#.........#...#.
#############################.
