..###################
........#.......#...#
#####.#.#.###.#####.#
#.....#...#...#.#...#
#.#.#########.#.#.###
#.#.#.#...#.........#
#.#.#.#.#######.###.#
#.#.#...........#.#.#
#.#####.###.###.#.###
#.....#.#.....#.#...#
###.#####.#.###.#.#.#
#.......#.#.#.....#.#
#####.###.#.#.#.#####
#.......#.#.#.#.....#
#######.#########.#.#
#.#.....#.....#...#.#
#.#.#.#####.#.###.#.#
#...#...#...#.#...#.#
#.###.###.###.#.###.#
#...#...#.#.......#.
###################.
