#$#########
#.#.....#.#
#.#.#.###.#
#...#...#.#
###.#.###.#
#...#.#...#
#####.###.#
#.....#.#.#
#.#.###.#.#
#.#.......#
#########&#
