..#########
..#.....#.#
#.#.#.###.#
#...#...#.#
###.#.###.#
#...#.#...#
#####.###.#
#.....#.#.#
#.#.###.#.#
#.#.......
#########.
