#$#######################################
#...........#.........#...#.#...........#
#.###.#.###.#.#####.###.#.#.###########.#
#...#.#...#.....#.#...~.#.....#.#...#.#.#
#.#####.#.#.#####.#.#.#####.###.#.###.#.#
#.#.....#.#.#.#.....#.#^#.#.#.#.#.......#
###.#####.###.#.#.#####.#.#.#.#.#####.###
#...#.....#.#.#.#...#.#...........#.#...#
#.#.###.###.#.#.###.#.#.#.#####.###.###.#
#.#.#.........#...#...#.#.#...#.........#
###.###.###########.###.###.#.###.#######
#...#.......#.#...#...#.#.#.#...#.#.....#
#.#####.#.###.###.#######.###.###.#.#.###
#...#...#.#.#...#.......#.#.........#...#
#.#######.#.#.###.#.###.#.###.###.#.###.#
#.#.....#.....#...#...#.#.....#.#.#.#...#
###.#.###.#.###.#####.###.#####.#.#######
#.#.#...#.#.#...#...#...#.#...#.......#.#
#.#####.#.###.#.###.#.#.###.#####.#.###.#
#...........#.#.#...#.#...#.....#.#.#...#
#####.#######.###.###.#.#.#.###.#.#####.#
#.....#.........#.#.#.#.#.#...#.#...#...#
#####.#########.#.#.#.#.###.#####.#.#.#.#
#...#...#...#.....#...#.....#...#.#.#.#.#
#.#####.###.#.#.#####.###.###.#####.###.#
#.#...#.#...#.#.#....^..#.#.#...#...#...#
#.#.#.#.#.###.#.#####.#.###.#.#.#.###.#.#
#.#.#...#.#...#...#...#.#.....#.#...#.#.#
#.#####.#.#####.###.#########.#####.###.#
#...#...#.......#....~..#.......#.......#
###.#.#.#.#.#######.#######.###.###.#.###
#.....#...#.#...#...#.......#...#.#.#...#
###.#.#.#.###.#################.#.#######
#...#.#.#...........#.........#.#...#...#
#.#####.#.#.###.#####.#.#######.###.###.#
#.#.....#.#.#.#.#.....#.#.#...#.....#...#
#.#####.#####.#.#####.###.#.#.#.#.#.###.#
#.....#.#...^.#...#.........#.#.#.#...#.#
#.#.#.#.###.###.#.#.#.#.#.###.#.#.###.#.#
#^#.#.#...#.....#.~.#.#.#...#...#^..#...#
#######################################&#
