#$#############################
#.........#.#...#...#^..#.....#
###.#.#.#.#.#.#####.#.#.###.#.#
#...#.#.#.....#.....#.#...#.#.#
###.#.#.#####.#.#######.###.#.#
#...#.#.....#.#...#.#.#.....#.#
###.#########.###.#.#.#.#####.#
#.........#.#.......#....~#...#
#.###.#.#.#.#########.#######.#
#.#.#.#.#...#...#...#...#.....#
#.#.#.#.#.###.#####.#.#####.###
#...#.#.#.#...#.........#.....#
#####.#.###.#.#.###.#####.#.###
#.....#~....#...#.....#...#.#.#
###.#.#.###.###.###.###.###.#.#
#...#.#.#...#.....#.#...#.#.#.#
#.#######.###.#########.#.###.#
#.#.#...#.#...#.#.#.#.#.#.....#
#.#.#.#.###.#.#.#.#.#.###.###.#
#..^#.#.#...#..^....#.#...#...#
#.#####.#.#.#####.###.###.#.###
#.......#.#.#...#.#.......#...#
###.#####.#.#.#.#.###.#.#####.#
#...#.....#...#.#...#^#...#.#.#
#.#.#.###.###.###.###.###.#.###
#.#.#...#.#.....#.#...#.......#
#####.#####.#####.#.#.#######.#
#...#...#.#...#.....#...#.....#
#.#.#.#.#.#.#######.#####.###.#
#.#^..#.#..~..#......^..#...#.#
#############################&#
